pays,or,argent,bronze,total_medals,score
United States,997,559,521,2077,4630
Russia,334,351,348,1033,2052
Germany,345,270,394,1009,1969
Australia,261,330,410,1001,1853
China,325,319,204,848,1817
Great Britain,231,212,229,672,1346
France,211,204,198,613,1239
Netherlands,176,200,130,506,1058
Japan,147,196,211,554,1044
Italy,140,180,221,541,1001
