pays,or,argent,bronze,total_medals,score
Canada,220,151,46,417,1008
United States,70,165,87,322,627
Germany,101,105,51,257,564
Norway,89,81,63,233,492
Russia,72,73,71,216,433
Sweden,78,61,58,197,414
Finland,17,56,162,235,325
Austria,40,48,66,154,282
Italy,33,36,50,119,221
South Korea,50,26,10,86,212
