pays,or,argent,bronze,total_medals,score
United States,2446,1351,1187,4984,11227
Soviet Union,830,635,596,2061,4356
Germany,585,539,644,1768,3477
Great Britain,522,619,598,1739,3402
France,486,527,536,1549,3048
Italy,514,484,462,1460,2972
Australia,372,478,571,1421,2643
Hungary,441,335,398,1174,2391
Sweden,332,378,330,1040,2082
Russia,335,358,350,1043,2071
