pays,or,argent,bronze,total_medals,score
Canada,289,189,97,575,1342
United States,141,271,121,533,1086
Soviet Union,228,81,81,390,927
Norway,151,165,127,443,910
Sweden,125,126,177,428,804
Finland,66,145,215,426,703
Germany,115,114,68,297,641
Austria,67,80,97,244,458
Russia,72,73,71,216,433
Switzerland,48,38,97,183,317
